==================================================.
S     |   |               |                 |     |
.===. | | '== .=========. | ==============. |== | |
|   |   |     |         | |   |           | |   | |
| ============' .====== | '=. | | ===== .=' | ====|
|         | |   |   |   |   | | |   |   |   |     |
| | ====. | | ==' | | ====. | | '=. '===' .=====. |
| |     |   |     | |     |   |   |       |     | |
| |===. |== '=. .====== .=====+== |=======| .=. | |
| |   | |     | |       |     |   |       | | |   |
| | | | | .===| | ======| ==. | ==' .==== | | '=. |
|   | | | |   | |       |   | |     |     | |   | |
|===' | '=| | | |====== | .=' '=====' .===' | .=' |
| |   |   | |   | |     | |       |   |     | |   |
| | .===. | '===| | ====| | ======' .=' | .=' | ==|
| | |   | |     | |     | |     |   |   | |   |   |
| | '== | '===. | '===. | |===. | .=' .=' | | |== |
| |     |     | |     |   |   |   |   |   | | |   |
| '==== '=. ==' '==== '===' | '=======' .=' | | =='
|         |                 |           |   |     E
'==================================================